{
  "size":[30,20],
  "map":[
  ["g","g","g","g","g","g","g","g","g","g","g","g","g","g","g","g","g","g","g","g","g","g","g","g","g","g","g","g","g","g","g","g"],
  ["x","x","x","x","x","x","x","x","x","x","x","x","x","x","x","x","x","x","x","x","x","x","x","x","x","x","x","x","x","x","x","x"],
  ["c","c","c","c","c","c","c","c","c","c","c","c","c","c","c","c","c","c","c","c","c","c","c","c","c","c","c","c","c","c","c","c"],
  ["g","g","g","g","g","g","g","g","g","g","g","g","g","g","g","g","g","g","g","g","g","g","g","g","g","g","g","g","g","g","g","g"],
  ["x","x","x","x","x","x","x","x","x","x","x","x","x","x","x","x","x","x","x","x","x","x","x","x","x","x","x","x","x","x","x","x"],
  ["c","c","c","c","c","c","c","c","c","c","c","c","c","c","c","c","c","c","c","c","c","c","c","c","c","c","c","c","c","c","c","c"],
  ["g","g","g","g","g","g","g","g","g","g","g","g","g","g","g","g","g","g","g","g","g","g","g","g","g","g","g","g","g","g","g","g"],
  ["x","x","x","x","x","x","x","x","x","x","x","x","x","x","x","x","x","x","x","x","x","x","x","x","x","x","x","x","x","x","x","x"],
  ["c","c","c","c","c","c","c","c","c","c","c","c","c","c","c","c","c","c","c","c","c","c","c","c","c","c","c","c","c","c","c","c"],
  ["g","g","g","g","g","g","g","g","g","g","g","g","g","g","g","g","g","g","g","g","g","g","g","g","g","g","g","g","g","g","g","g"],
  ["x","x","x","x","x","x","x","x","x","x","x","x","x","x","x","x","x","x","x","x","x","x","x","x","x","x","x","x","x","x","x","x"],
  ["c","c","c","c","c","c","c","c","c","c","c","c","c","c","c","c","c","c","c","c","c","c","c","c","c","c","c","c","c","c","c","c"],
  ["g","g","g","g","g","g","g","g","g","g","g","g","g","g","g","g","g","g","g","g","g","g","g","g","g","g","g","g","g","g","g","g"],
  ["x","x","x","x","x","x","x","x","x","x","x","x","x","x","x","x","x","x","x","x","x","x","x","x","x","x","x","x","x","x","x","x"],
  ["c","c","c","c","c","c","c","c","c","c","c","c","c","c","c","c","c","c","c","c","c","c","c","c","c","c","c","c","c","c","c","c"],
  ["g","g","g","g","g","g","g","g","g","g","g","g","g","g","g","g","g","g","g","g","g","g","g","g","g","g","g","g","g","g","g","g"],
  ["x","x","x","x","x","x","x","x","x","x","x","x","x","x","x","x","x","x","x","x","x","x","x","x","x","x","x","x","x","x","x","x"],
  ["c","c","c","c","c","c","c","c","c","c","c","c","c","c","c","c","c","c","c","c","c","c","c","c","c","c","c","c","c","c","c","c"],
  ["g","g","g","g","g","g","g","g","g","g","g","g","g","g","g","g","g","g","g","g","g","g","g","g","g","g","g","g","g","g","g","g"],
  ["x","x","x","x","x","x","x","x","x","x","x","x","x","x","x","x","x","x","x","x","x","x","x","x","x","x","x","x","x","x","x","x"],
  ["c","c","c","c","c","c","c","c","c","c","c","c","c","c","c","c","c","c","c","c","c","c","c","c","c","c","c","c","c","c","c","c"],
  ["g","g","g","g","g","g","g","g","g","g","g","g","g","g","g","g","g","g","g","g","g","g","g","g","g","g","g","g","g","g","g","g"]
  ]
}